R 720 480

NO ./textures/north_wall.xpm
SO ./textures/south_wall.xpm
WE ./textures/west_wall.xpm
EA ./textures/east_wall.xpm
S ./textures/sprite.xpm

F 100,100,100
C 225,225,255

 11111111111111111111111
1000100000110000000000001
1000000001110000200000001
1001000000000000000000001
10110000011100000000000001
1000000000110000011101111111111
 110001111  10101110000000000001
  100111  1 1001 101010000000001
 10000001101010111000000100010001
100020000000000000001110100011001
10000000000000011101  1010001 1001
 10000011101011   1    110N001 11
  11011   1 1            1011
    1                    101
                         101
                         121
                          1